40 23
########################################
#~      ~ ~~  ~  ~ ~~   ~ ~~    ~ ~ ~~ #
#~~ ~          ~~   ~   ~ ~~         ~ #
#~# ~~   ~~~~      ~  ~~~~  ~    ~~~  ~#
# ~        ~   ~ ~~ #~~       ~        #
#~~  ~~~   ~ ~ ~      ~ ~~ ~  ~  ~  ~  #
#     ~~  ~  ~ ~ ~~~       H    ~  #~  #
#  O~  ~  #  ~~~ ~      ~ ~~  ~  ~ ~~  #
#       ~ ~H~~   ~~ ~ #        ~~   ~  #
# ~~         ~ ~~~  ~~   ~~~~      ~  ~#
#~  ~    ~~~  ~   ~        ~   ~ ~~  ~~#
#     ~      # ~ ~~  ~~~   ~ ~ ~ #    ~#
#~ ~ ~~  ~  ~   H     ~~  ~~ ~ ~ ~~~   #
#       ~   ~   ~   ~  ~     ~~~ ~     #
# ~~  ~  ~ ~~   ~       ~ ~ ~     ~    #
#      ~~   ~   ~  ~         ~      ~~ #
#~ ~     #    ~~~~  ~    ~~~H   # ~    #
#  ~   ~ ~   ~        ~          ~~  ~ #
#  ~   ~     #~  ~   ~~  ~  ~         ~#
# ~~ ~ ~  ~~                ~   ~      #
#    ~~~        ~ ~~  ~  ~  ~   ~      #
# ~ ~     ~            ~~   ~   ~  ~   #
########################################
RRDDDRRRWWDRDRLWUDRRRRDUDLRRRRDURWDRWUUL
