###########################
#                         #
#       #     @           #
#       #         #      ##
#       #         ####o####
 #      #                 #
  #                       #
   #              #########
    #                     @
     ######################
